11111111111111
11111111EPC111
10000000000001
11111111111111
11111111111111
