111111111111111111111111
1C001001C0E1P00000001P11
111E00010011111010110001
10P011000111000C10011001
1001CE010000P111100CP011
111111111111111111111111
