111111111111111111111111
11C01001C0E1P00000101P11
111E00010011111010110001
10P011000111000C10011001
1001CE010000P111100CP011
111111111111111111111111
