111111111111111111111111
1C111P1111E1111P11111111
111E11111111111111111111
111111111111111111111111
11C11E11111C1111111P1111
111111111111111111111111
