111111111111111111111111111111
1P101111C111111111111111111111
1CC1111111111111111111111111E1
111111111111111111111111111111
