11111
1P0E1
101C1
1E0P1
11111
