1111111111
10C1P00C01
101E110111
1C000000C1
1111111111