11111111
10000P01
1E0P0001
1000P001
10C00P01
11111111
