11111
10C01
10P01
10E01
11111
